+--+--+--+--+--+--+--+--+--+
|        |                 |
+  +--+  +  +--+--+--+--+  +
|  |  |  |  |           |  |
+  +  +  +  +  +--+--+  +  +
|  |     |b |  |     |  |  |
+  +--+--+--+  +--+  +  +  +
|     |  |        |     |  |
+  +  +  +--+--+--+  +  +  +
|  |  |           |  |  |  |
+  +  +--+--+--+  +  +  +  +
|  |         h |  |  |  |  |
+  +--+--+--+--+  +  +--+  +
|                 |        |
+--+--+--+--+--+--+--+--+--+