+--+--+--+--+
|    b      |
+  +--+  +  +
|h |     |  |
+  +  +--+--+
|  |   c    |
+  +--+--+  +
|        | g|
+--+--+--+--+